
NO textures/palma.xpm
SO textures/boy.xpm
WE textures/drink.xpm
EA textures/love.xpm

F 245,222,179
C 25  , 25   ,   112

111111111111111111111111111111111
110000011000000000110000000000001
111100011011000001110000000000001
111110000001000000000000000000001
111111111011000001110000000000001
100000000011000001110111111111111
11110110011111011100000010001
11110110000111011101010010001
1100000N010101011100000010001
10001001001000001100000010001
10000010000001001101010010001
1100000111010101111101111000111
11110111 1110101 101111010001
11111111 1111111 111111111111
