
NO textures/hh1.xpm
SO textures/hh2.xpm
WE textures/hh3.xpm
EA textures/hh4.xpm

F 188  , 143   ,   143
C 173,216,230


        1111111111111111111111111
        1000000000000000000000001
        1000000000000000000000001
        1000111100000000000000001
        1000000111100000000000001
        1000000001111111000000001
        1000000111000110000000001
        1000011111110000000000001
        1000000000000000000000001
        1000000000000000000000001
        1000000000000011000000001
        1000000000000011000000001
        1000000000000001100000001
        1000000111000000001000001
        1100000001110000000011101
        1000000000011000011100001
        1000000000000101100000001
        1000000000000011000000001
        1000000000000000000000001
        1000000000000000000000001
        1000000000000000000000001
        1000000000000000000000001
111111111000000000000000000000001
1000000000000000W0000000000011111
10000000000000000000000000001
10000000000000000001010000001
11000001110101011111011110101
11110111 1110111 101111010001
11111111 1111111 111111111111
